10
6,3,9,4,2,6,8,9,6,7
0,0,9,5,1,4,5,4,7,0
0,0,4,5,2,7,2,9,0,7
9,4,0,0,7,2,5,0,9,4
5,5,0,0,7,9,0,5,2,5
1,2,7,7,0,0,4,7,2,12
4,7,2,9,0,0,4,9,3,5
5,2,5,0,4,4,0,0,2,9
4,9,0,5,7,9,0,0,1,7
7,0,9,2,2,3,2,1,0,0
0,7,4,5,12,5,9,7,0,0
