9
5 7 6 8 7 5 6 8 7
0 8 5 7 6 5 8 6 7
8 0 5 6 7 8 5 6 6
5 5 0 6 8 6 7 7 5
7 6 6 0 7 8 6 8 8
6 7 8 7 0 5 5 6 7
5 8 6 8 5 0 6 7 5
8 5 7 6 5 6 0 6 7
6 6 7 8 6 7 6 0 6
7 6 5 8 7 5 7 6 0
