13
20,3,9,3,7,3,7,5,9,6,5,3,9
0,10,2,0,2,5,4,5,2,2,5,5,5
10,0,1,1,5,0,0,2,1,0,2,5,0
2,1,0,3,5,5,5,1,0,3,0,5,5
0,1,3,0,2,2,1,5,0,0,2,5,10
2,5,5,2,0,6,0,1,5,5,5,1,0
5,0,5,2,6,0,5,2,10,0,5,0,0
4,0,5,1,0,5,0,0,10,5,10,0,2
5,2,1,5,1,2,0,0,0,4,0,0,5
2,1,0,0,5,10,10,0,0,5,0,5,0
2,0,3,0,5,0,5,4,5,0,3,3,0
5,2,0,2,5,5,10,0,0,3,0,10,2
5,5,5,5,1,0,0,0,5,3,10,0,4
5,0,5,10,0,0,2,5,0,0,2,4,0
