11
3,9,3,7,3,7,5,9,6,5,10
0,20,2,8,0,9,5,7,0,20,3
20,0,8,9,13,17,16,1,8,6,7
2,8,0,18,0,10,4,18,5,8,0
8,9,18,0,6,16,10,4,2,14,6
0,13,0,6,0,6,0,11,0,8,2
9,17,10,16,6,0,6,13,2,7,18
5,16,4,10,0,6,0,1,11,15,7
7,1,18,4,11,13,1,0,1,7,2
0,8,5,2,0,2,11,1,0,12,0
20,6,8,14,8,7,15,7,12,0,3
3,7,0,6,2,18,7,2,0,3,0
