12
9,3,9,3,7,3,7,3,9,6,9,3
0,1,1,5,0,0,2,1,0,2,5,0
1,0,3,5,8,4,3,0,6,0,5,5
1,3,0,2,2,1,5,0,0,2,5,10
5,5,2,0,6,0,1,8,5,15,1,0
0,8,2,6,0,2,5,10,0,5,0,0
0,4,1,0,2,0,0,10,5,10,0,2
2,3,5,1,5,0,0,0,4,0,0,5
1,0,0,8,10,10,0,0,12,0,5,0
0,6,0,5,0,5,4,12,0,3,3,0
2,0,2,15,5,10,0,0,3,0,10,2
5,5,5,1,0,0,0,5,3,10,0,4
0,5,10,0,0,2,5,0,0,2,4,0
