10
8 10 5 2 9 4 9 4 3 3 
0 4 5 8 6 7 6 8 4 6 
4 0 8 6 9 10 1 5 8 4 
5 8 0 4 8 2 2 6 9 8 
8 6 4 0 3 8 1 2 3 5 
6 9 8 3 0 9 4 6 8 9 
7 10 2 8 9 0 8 8 9 8 
6 1 2 1 4 8 0 1 4 6 
8 5 6 2 6 8 1 0 8 1 
4 8 9 3 8 9 4 8 0 10 
6 4 8 5 9 8 6 1 10 0 
