10
9 4 5 9 6 1 7 10 2 2 
0 10 2 2 4 10 5 6 2 9 
10 0 10 4 2 10 3 5 9 2 
2 10 0 6 1 7 9 8 10 6 
2 4 6 0 5 7 3 3 6 4 
4 2 1 5 0 2 5 10 7 7 
10 10 7 7 2 0 2 8 4 3 
5 3 9 3 5 2 0 8 9 5 
6 5 8 3 10 8 8 0 3 2 
2 9 10 6 7 4 9 3 0 9 
9 2 6 4 7 3 5 2 9 0 
