10
7 3 6 8 6 1 9 3 3 3 
0 7 8 9 2 1 9 5 3 6 
7 0 8 4 5 7 8 8 7 7 
8 8 0 10 9 7 6 2 7 1 
9 4 10 0 9 1 9 5 10 6 
2 5 9 9 0 1 9 4 6 1 
1 7 7 1 1 0 8 10 7 4 
9 8 6 9 9 8 0 4 1 7 
5 8 2 5 4 10 4 0 6 6 
3 7 7 10 6 7 1 6 0 4 
6 7 1 6 1 4 7 6 4 0 
