10
6 10 2 2 3 5 1 5 5 2 
0 10 3 3 1 3 2 5 2 9 
10 0 5 7 6 10 10 6 7 1 
3 5 0 2 9 8 2 7 10 8 
3 7 2 0 4 3 6 9 3 10 
1 6 9 4 0 3 5 6 9 8 
3 10 8 3 3 0 1 2 3 8 
2 10 2 6 5 1 0 4 3 9 
5 6 7 9 6 2 4 0 7 10 
2 7 10 3 9 3 3 7 0 4 
9 1 8 10 8 8 9 10 4 0 
