10
2 10 4 6 6 7 9 10 5 5 
0 5 1 5 10 3 1 8 7 10 
5 0 1 4 6 10 2 2 2 5 
1 1 0 9 6 8 3 4 4 9 
5 4 9 0 8 4 7 9 10 7 
10 6 6 8 0 9 1 6 6 8 
3 10 8 4 9 0 8 8 3 5 
1 2 3 7 1 8 0 6 6 2 
8 2 4 9 6 8 6 0 9 10 
7 2 4 10 6 3 6 9 0 8 
10 5 9 7 8 5 2 10 8 0 
