10
1 1 1 1 1 1 1 1 1 1 
0 4 1 2 6 3 2 1 5 4 
4 0 9 4 6 7 4 10 1 5 
1 9 0 2 2 7 7 7 10 10 
2 4 2 0 3 9 7 5 5 9 
6 6 2 3 0 4 10 9 8 5 
3 7 7 9 4 0 3 9 8 7 
2 4 7 7 10 3 0 2 6 10 
1 10 7 5 9 9 2 0 9 3 
5 1 10 5 8 8 6 9 0 5 
4 5 10 9 5 7 10 3 5 0 
