10
9 6 3 5 2 10 6 9 6 6 
0 1 10 9 5 6 1 9 4 7 
1 0 5 1 8 3 9 8 4 9 
10 5 0 9 7 1 7 4 2 2 
9 1 9 0 5 2 9 3 4 8 
5 8 7 5 0 10 3 4 10 8 
6 3 1 2 10 0 6 4 3 3 
1 9 7 9 3 6 0 1 10 10 
9 8 4 3 4 4 1 0 4 8 
4 4 2 4 10 3 10 4 0 6 
7 9 2 8 8 3 10 8 6 0 
