10
9 9 6 3 8 2 2 9 3 10 
0 7 7 5 1 1 3 6 4 10 
7 0 4 5 2 3 4 4 10 8 
7 4 0 2 3 8 3 4 7 9 
5 5 2 0 4 4 9 2 1 7 
1 2 3 4 0 3 9 1 10 3 
1 3 8 4 3 0 8 8 8 2 
3 4 3 9 9 8 0 2 7 2 
6 4 4 2 1 8 2 0 4 5 
4 10 7 1 10 8 7 4 0 1 
10 8 9 7 3 2 2 5 1 0 
