10
1 6 2 10 8 2 4 10 6 10 
0 1 3 6 1 9 2 1 8 10 
1 0 7 10 3 2 9 10 1 7 
3 7 0 5 7 7 10 9 6 1 
6 10 5 0 3 10 4 3 3 9 
1 3 7 3 0 3 7 1 5 4 
9 2 7 10 3 0 1 10 3 3 
2 9 10 4 7 1 0 2 4 6 
1 10 9 3 1 10 2 0 5 1 
8 1 6 3 5 3 4 5 0 3 
10 7 1 9 4 3 6 1 3 0 
