10
1 1 1 1 1 1 1 1 1 1 
0 10 5 9 2 8 8 10 7 7 
10 0 9 1 8 7 5 2 8 10 
5 9 0 3 8 7 10 1 5 7 
9 1 3 0 7 8 4 9 6 8 
2 8 8 7 0 3 6 2 4 7 
8 7 7 8 3 0 2 3 8 10 
8 5 10 4 6 2 0 1 6 2 
10 2 1 9 2 3 1 0 8 5 
7 8 5 6 4 8 6 8 0 6 
7 10 7 8 7 10 2 5 6 0 
