9
2 8 9 7 3 4 6 8 9
0 0 2 8 7 4 0 1 6
0 0 8 0 2 7 4 4 6
2 8 0 2 7 8 0 2 6
8 0 2 0 5 0 8 8 6
7 2 7 5 0 5 4 7 6
4 7 8 0 5 0 8 2 6
0 4 0 8 4 8 0 4 6
1 4 2 8 7 2 4 0 6
6 6 6 6 6 6 6 6 0
